NO textures/NO.xpm
SO textures/SO.xpm
WE textures/WE.xpm
EA textures/EA.xpm
F 80, 75, 61
C 165, 176, 196


a
v
g

        11111111 11111111111 11111111    11111111111   11111111111111111111111111111111111
    111111000001110000000001110000001    10000000001   10000000000000000000000000000000001111111111111111111111111111
1111100000000000000000000000000000001    10000000001   10000000000000000000000000000000000002000000000000000000000001
1000000000000000000000011111111111111    10000000001   10000000000000000000000000000000000002000000000000000000000001111
100000000000000000000001                 10000000001   10000000000000000000000000000000001111111100000000000000000000001
100000000000000000000001111111111111111111000000000111110000000000000000000000000000000001      100000000000000000000001
100000000000000000000000000000000000000000000000000002000000000000000000000000000000000001      111111111111000000000001
100000000000000000111100000000000000000000000000000002000000000000000000000000000000000001                 1000000000001
1000000000000000001  100000000000000000000000000000002000000000000000000000000000011111111                 1000000000001
100000000000000000111100000000000000000000000000000002000000000000000000000000000011111111111111111111111  1000000000001
100000000000000000000000000000000000000000000000000002000000000000000000000000000000000000000000000000001  1000000000001
110000000000011111100000000000000N00000000000000000002000000000000000000000000000000000000000000000000001  1000000000001
 1000000000001    100000000000000000000000000000000002000000000000000000000000000000000000000000000000001  1000000000001
11000000000001    100000000000000000000000000000000002000000000000000000000000000000000000000000000000001  1000000000001
100000000000011111100000000000000000000000000000000002000000000000000000000000000000000000000000000000001  1000000000001
100000000000000000000000000000000000000000000000000002000000000000000000000000000000000000000000000000001  1000000000001
100000000000000000000000001111111111111111111111111111111111111111111111111111111111111111111111111111111  1000000000001
100000000000000000000000001                                                                                1000000000001
100000000000000000000000001111111111111111111111111111111111111111111111111111111111111111111111111111111111000000000001
100000000001110000000000000000000000000000000000000000020000000000000000000000000000000000000000000000000000000000000001
100011110001 10000000000000000000000000000000000000000020000000000000000000000000000000000000000000000000000000000000001
11111  10001 10000000000000000000000000000000000000000020000000000000000000000000000000000000000000000000000000000000001
       11111 11111111111111111111111111111111111111111111111111111111111111111111111111111111111111111111111111111111111