11111111111111111111
10000100000000000001
100002000000000000011111
100001000000000000000001
100001111111111110000001
1000000000000000100000011111111111
1000000000000000100000000000000001
1011110000000000100000000000000001
101  10000000000100000000011111111
101111100000000011111000001
1000001000000000000010000011111111111111111111111
1000001000000000000010000000000000000000000000001
1000001000000000000011111111111111111111110000001
1000001000000000000010000000000000000000000000001
1000001000000000000010000000000000000000000000001
1000000000000000000000000011111111111111111111111
100000000000000000000000001
100000000000000000000000001
100000000000000000000000001
100011110001110000000000001
10001  10001 10000000000001
11111  10001 10000000000001
       11111 11111111111111